1111111111111111
1E00C00000000C01
100011100010C011
1C00101000010001
10011110001P0001
1110000000111111
1000100001111001
1111111111111111